[2, 18, 33, 51, 66, 81, 96, 111, 126, 141, 156, 171, 186, 201, 216, 234, 249, 264, 279, 294]
[7, 22, 37, 52, 67, 82, 97, 115, 130, 145, 160, 175, 190, 205, 220, 235, 250, 265, 280, 295]
[8, 23, 41, 56, 71, 86, 101, 116, 131, 146, 161, 176, 191, 206, 221, 239, 254, 269, 284, 299]
[12, 27, 42, 57, 72, 87, 105, 120, 135, 150, 165, 180, 195, 210, 225, 240, 255, 270, 285, 300]
[13, 28, 46, 61, 76, 91, 106, 121, 136, 151, 166, 181, 196, 211, 229, 244, 259, 274, 289, 304]
[17, 32, 47, 62, 77, 92, 110, 125, 140, 155, 170, 185, 200, 215, 230, 245, 260, 275, 290, 305]
