[1, 12, 24, 36, 46, 56, 68, 78, 88, 101]
[2, 14, 28, 38, 48, 60, 70, 80, 92]
[4, 16, 30, 40, 52, 62, 72, 84, 94]
[6, 20, 32, 44, 54, 64, 76, 86, 96]
[8, 22, 99]
[3, 13, 27, 37, 47, 59, 69, 79, 91, 100]
[5, 19, 29, 39, 51, 61, 71, 83, 93]
[11, 21, 31, 43, 53, 63, 75, 85, 98]
[35, 45, 55, 67, 77, 87]
