[2, 11, 19, 27, 35, 42, 50, 58, 66]
[5, 12, 20, 28, 36, 44, 52, 60, 67]
[6, 14, 21, 29, 37, 45, 53, 61, 69]
[7, 15, 23, 31, 38, 46, 54, 62, 70]
[8, 16, 24, 32, 40, 48, 56, 63, 71]
[10, 18, 25, 33, 41, 49, 57, 65]
