[1, 2, 3, 4, 5, 6]
[8, 11, 12, 13, 14]
[16, 19, 20, 21, 22]
[24, 27, 28, 29, 30, 31, 32]
[35, 36, 37, 38, 39, 40, 43, 44]
[45, 46, 47, 48, 51, 52, 53, 54, 55, 56]
[59, 60, 61, 62, 63, 64, 67, 68]
[69, 70, 71, 72, 75, 76, 77, 78, 79, 80]
[83, 84, 85, 86, 87, 88, 91, 92, 93, 94]
[96, 98, 99, 100, 101]
