[2]
[5, 6, 7, 8, 10, 11, 12, 14, 15, 16]
[18, 19, 20, 21, 23, 24, 25, 27, 28, 29, 31, 32, 33, 35, 36, 37, 39, 40, 41, 43, 44, 45, 47, 48, 49]
[51, 52, 53, 54, 56, 57, 58, 60, 61, 62, 64, 65, 66, 68, 69, 70, 72, 73, 74]
[76, 77, 78, 80, 81, 82, 84, 85, 86, 88, 89, 90, 92, 93, 94, 96, 97, 98]
[100, 101, 102, 104, 105, 106, 108, 109, 110, 112, 113, 114, 116, 117, 118, 120]
[121, 122, 124, 125, 126, 128, 129, 130, 132, 133, 134, 136, 137, 138, 140]
[141, 142, 144, 145, 146, 148, 149, 150, 152, 153, 154, 156, 157, 158, 160, 161, 162]
[164, 165, 166, 168, 169, 170, 172, 173, 174, 176, 177, 178, 180, 181, 182, 184, 185, 186]
[188, 189, 190, 192, 193, 194, 196, 197, 198, 199, 201, 202, 203, 205, 206, 207]
