[1, 8, 20, 28, 36, 44, 52, 60, 68, 76, 84, 92, 101]
[2, 12, 22, 30, 38, 46, 54, 62, 70, 78, 86, 94]
[4, 14, 24, 32, 40, 48, 56, 64, 72, 80, 88, 96]
[6, 16, 99]
[3, 11, 19, 29, 37, 45, 53, 61, 69, 77, 85, 93, 100]
[5, 13, 21, 31, 39, 47, 55, 63, 71, 79, 87, 98]
[27, 35, 43, 51, 59, 67, 75, 83, 91]
