[1, 12, 22, 32, 40, 52, 60, 70, 78, 88, 99]
[2, 14, 24, 36, 44, 54, 62, 72, 80, 92, 101]
[4, 16, 28, 38, 46, 56, 64, 76, 84, 94]
[6, 20, 30, 48, 68, 86, 96]
[8]
[3, 11, 21, 31, 43, 51, 61, 69, 79, 87, 98]
[5, 13, 27, 35, 45, 53, 63, 71, 83, 91, 100]
[19, 29, 37, 47, 55, 67, 75, 85, 93]
[39, 59, 77]
