[1, 14, 28, 40, 52, 64, 76, 88, 101]
[2, 16, 30, 44, 54, 68, 78, 92]
[4, 20, 32, 46, 56, 70, 80, 94]
[6, 22, 36, 48, 60, 72, 84, 96]
[8, 24, 38, 62, 86, 99]
[12]
[3, 13, 29, 39, 53, 63, 77, 87, 100]
[5, 19, 31, 43, 55, 67, 79, 91]
[11, 21, 35, 45, 59, 69, 83, 93]
[27, 37, 47, 61, 71, 85, 98]
[51, 75]
