[2, 12, 21, 31, 40, 49, 58, 68, 77, 86, 96, 105, 114, 124, 133, 142, 152, 161, 170, 180, 189, 198, 207]
[5, 14, 23, 32, 41, 51, 60, 69, 78, 88, 97, 106, 116, 125, 134, 144, 153, 162, 172, 181, 190, 199]
[6, 15, 24, 33, 43, 52, 61, 70, 80, 89, 98, 108, 117, 126, 136, 145, 154, 164, 173, 182, 192, 201]
[7, 16, 25, 35, 44, 53, 62, 72, 81, 90, 100, 109, 118, 128, 137, 146, 156, 165, 174, 184, 193, 202]
[8, 18, 27, 36, 45, 54, 64, 73, 82, 92, 101, 110, 120, 129, 138, 148, 157, 166, 176, 185, 194, 203]
[10, 19, 28, 37, 47, 56, 65, 74, 84, 93, 102, 112, 121, 130, 140, 149, 158, 168, 177, 186, 196, 205]
[11, 20, 29, 39, 48, 57, 66, 76, 85, 94, 104, 113, 122, 132, 141, 150, 160, 169, 178, 188, 197, 206]
