[2, 10, 16, 23, 29, 36, 43, 49, 56, 62, 69, 76, 82, 89, 96, 102, 109, 116, 122, 129, 136, 142, 149, 156, 162, 169, 176, 182, 189, 196, 202]
[5, 11, 18, 24, 31, 37, 44, 51, 57, 64, 70, 77, 84, 90, 97, 104, 110, 117, 124, 130, 137, 144, 150, 157, 164, 170, 177, 184, 190, 197, 203]
[6, 12, 19, 25, 32, 39, 45, 52, 58, 65, 72, 78, 85, 92, 98, 105, 112, 118, 125, 132, 138, 145, 152, 158, 165, 172, 178, 185, 192, 198, 205]
[7, 14, 20, 27, 33, 40, 47, 53, 60, 66, 73, 80, 86, 93, 100, 106, 113, 120, 126, 133, 140, 146, 153, 160, 166, 173, 180, 186, 193, 199, 206]
[8, 15, 21, 28, 35, 41, 48, 54, 61, 68, 74, 81, 88, 94, 101, 108, 114, 121, 128, 134, 141, 148, 154, 161, 168, 174, 181, 188, 194, 201, 207]
