[2]
[7, 8, 12, 13, 17, 18, 22, 23, 27, 28, 32, 33, 37]
[41, 42, 46, 47, 51, 52, 56, 57, 61, 62, 66, 67]
[71, 72, 76, 77, 81, 82, 86, 87, 91, 92, 96, 97, 101]
[105, 106, 110, 111, 115, 116, 120, 121, 125, 126, 130, 131, 135, 136, 140, 141]
[145, 146, 150, 151, 155, 156, 160, 161, 165, 166, 170, 171, 175, 176, 180, 181]
[185, 186, 190, 191, 195, 196, 200, 201, 205, 206, 210, 211, 215, 216, 220, 221, 225]
[229, 230, 234, 235, 239, 240, 244, 245, 249, 250, 254, 255, 259, 260, 264, 265]
[269, 270, 274, 275, 279, 280, 284, 285, 289, 290, 294, 295, 299, 300, 304, 305]
