[1, 6, 14, 22, 30, 38, 44, 52, 56, 64, 70, 78, 84, 92, 99]
[2, 8, 16, 24, 32, 40, 46, 54, 60, 68, 72, 80, 86, 94, 101]
[4, 12, 20, 28, 36, 48, 62, 76, 88, 96]
[3, 11, 19, 27, 31, 37, 45, 51, 59, 63, 71, 77, 85, 91, 98]
[5, 13, 21, 29, 35, 39, 47, 53, 61, 67, 75, 79, 87, 93, 100]
[43, 55, 69, 83]
