[2]
[5, 6, 7, 8, 10, 11, 12, 14, 15, 16]
[18, 19, 20, 21, 23, 24, 25, 27, 28, 29, 31, 32, 33]
[35, 36, 37, 38, 40, 41, 42, 44, 45, 46]
[48, 49, 50, 52, 53, 54, 56, 57, 58]
[60, 61, 62, 63, 65, 66, 67, 69, 70, 71]
