[2, 22, 41, 57, 76, 92, 111, 130, 146, 165, 181, 200, 216, 235, 254, 270, 289, 305]
[7, 23, 42, 61, 77, 96, 115, 131, 150, 166, 185, 201, 220, 239, 255, 274, 290]
[8, 27, 46, 62, 81, 97, 116, 135, 151, 170, 186, 205, 221, 240, 259, 275, 294]
[12, 28, 47, 66, 82, 101, 120, 136, 155, 171, 190, 206, 225, 244, 260, 279, 295]
[13, 32, 51, 67, 86, 105, 121, 140, 156, 175, 191, 210, 229, 245, 264, 280, 299]
[17, 33, 52, 71, 87, 106, 125, 141, 160, 176, 195, 211, 230, 249, 265, 284, 300]
[18, 37, 56, 72, 91, 110, 126, 145, 161, 180, 196, 215, 234, 250, 269, 285, 304]
