[2, 16, 29, 43, 56, 69, 82, 96, 109, 122, 136, 149, 162, 176, 189, 202]
[5, 18, 31, 44, 57, 70, 84, 97, 110, 124, 137, 150, 164, 177, 190, 203]
[6, 19, 32, 45, 58, 72, 85, 98, 112, 125, 138, 152, 165, 178, 192, 205]
[7, 20, 33, 47, 60, 73, 86, 100, 113, 126, 140, 153, 166, 180, 193, 206]
[8, 21, 35, 48, 61, 74, 88, 101, 114, 128, 141, 154, 168, 181, 194, 207]
[10, 23, 36, 49, 62, 76, 89, 102, 116, 129, 142, 156, 169, 182, 196]
[11, 24, 37, 51, 64, 77, 90, 104, 117, 130, 144, 157, 170, 184, 197]
[12, 25, 39, 52, 65, 78, 92, 105, 118, 132, 145, 158, 172, 185, 198]
[14, 27, 40, 53, 66, 80, 93, 106, 120, 133, 146, 160, 173, 186, 199]
[15, 28, 41, 54, 68, 81, 94, 108, 121, 134, 148, 161, 174, 188, 201]
