[2, 14, 24, 35, 45, 56, 66, 77, 88, 98, 109, 120, 130, 141, 152, 162, 173, 184, 194, 205]
[5, 15, 25, 36, 47, 57, 68, 78, 89, 100, 110, 121, 132, 142, 153, 164, 174, 185, 196, 206]
[6, 16, 27, 37, 48, 58, 69, 80, 90, 101, 112, 122, 133, 144, 154, 165, 176, 186, 197, 207]
[7, 18, 28, 39, 49, 60, 70, 81, 92, 102, 113, 124, 134, 145, 156, 166, 177, 188, 198]
[8, 19, 29, 40, 51, 61, 72, 82, 93, 104, 114, 125, 136, 146, 157, 168, 178, 189, 199]
[10, 20, 31, 41, 52, 62, 73, 84, 94, 105, 116, 126, 137, 148, 158, 169, 180, 190, 201]
[11, 21, 32, 43, 53, 64, 74, 85, 96, 106, 117, 128, 138, 149, 160, 170, 181, 192, 202]
[12, 23, 33, 44, 54, 65, 76, 86, 97, 108, 118, 129, 140, 150, 161, 172, 182, 193, 203]
