[2, 15, 27, 39, 51, 62, 74, 86, 98, 110, 122, 134, 146, 158, 170, 182, 194, 206]
[5, 16, 28, 40, 52, 64, 76, 88, 100, 112, 124, 136, 148, 160, 172, 184, 196, 207]
[6, 18, 29, 41, 53, 65, 77, 89, 101, 113, 125, 137, 149, 161, 173, 185, 197]
[7, 19, 31, 43, 54, 66, 78, 90, 102, 114, 126, 138, 150, 162, 174, 186, 198]
[8, 20, 32, 44, 56, 68, 80, 92, 104, 116, 128, 140, 152, 164, 176, 188, 199]
[10, 21, 33, 45, 57, 69, 81, 93, 105, 117, 129, 141, 153, 165, 177, 189, 201]
[11, 23, 35, 47, 58, 70, 82, 94, 106, 118, 130, 142, 154, 166, 178, 190, 202]
[12, 24, 36, 48, 60, 72, 84, 96, 108, 120, 132, 144, 156, 168, 180, 192, 203]
[14, 25, 37, 49, 61, 73, 85, 97, 109, 121, 133, 145, 157, 169, 181, 193, 205]
