[1, 8, 16, 24, 32, 40, 47, 55, 63]
[3, 10, 18, 27, 34, 42, 49, 57, 65]
[4, 12, 20, 28, 36, 43, 51, 59, 66]
[7, 15, 22, 30, 38, 45, 54, 61]
[2, 9, 17, 26, 33, 41, 48, 56, 64]
[6, 14, 21, 29, 37, 44, 53, 60]
