[2, 17, 28, 42, 56, 67, 81, 92, 106, 120, 131, 145, 156, 170, 181, 195, 206, 220, 234, 245, 259, 270, 284, 295]
[7, 18, 32, 46, 57, 71, 82, 96, 110, 121, 135, 146, 160, 171, 185, 196, 210, 221, 235, 249, 260, 274, 285, 299]
[8, 22, 33, 47, 61, 72, 86, 97, 111, 125, 136, 150, 161, 175, 186, 200, 211, 225, 239, 250, 264, 275, 289, 300]
[12, 23, 37, 51, 62, 76, 87, 101, 115, 126, 140, 151, 165, 176, 190, 201, 215, 229, 240, 254, 265, 279, 290, 304]
[13, 27, 41, 52, 66, 77, 91, 105, 116, 130, 141, 155, 166, 180, 191, 205, 216, 230, 244, 255, 269, 280, 294, 305]
