[2, 23, 46, 66, 86, 106, 126, 146, 166, 186, 206, 229, 249, 269, 289]
[7, 27, 47, 67, 87, 110, 130, 150, 170, 190, 210, 230, 250, 270, 290]
[8, 28, 51, 71, 91, 111, 131, 151, 171, 191, 211, 234, 254, 274, 294]
[12, 32, 52, 72, 92, 115, 135, 155, 175, 195, 215, 235, 255, 275, 295]
[13, 33, 56, 76, 96, 116, 136, 156, 176, 196, 216, 239, 259, 279, 299]
[17, 37, 57, 77, 97, 120, 140, 160, 180, 200, 220, 240, 260, 280, 300]
[18, 41, 61, 81, 101, 121, 141, 161, 181, 201, 221, 244, 264, 284, 304]
[22, 42, 62, 82, 105, 125, 145, 165, 185, 205, 225, 245, 265, 285, 305]
