[2, 27, 51, 72, 96, 120, 141, 165, 186, 210, 234, 255, 279, 300]
[7, 28, 52, 76, 97, 121, 145, 166, 190, 211, 235, 259, 280, 304]
[8, 32, 56, 77, 101, 125, 146, 170, 191, 215, 239, 260, 284, 305]
[12, 33, 57, 81, 105, 126, 150, 171, 195, 216, 240, 264, 285]
[13, 37, 61, 82, 106, 130, 151, 175, 196, 220, 244, 265, 289]
[17, 41, 62, 86, 110, 131, 155, 176, 200, 221, 245, 269, 290]
[18, 42, 66, 87, 111, 135, 156, 180, 201, 225, 249, 270, 294]
[22, 46, 67, 91, 115, 136, 160, 181, 205, 229, 250, 274, 295]
[23, 47, 71, 92, 116, 140, 161, 185, 206, 230, 254, 275, 299]
