[2, 10, 16, 23, 29, 36, 42, 49, 56, 62, 69]
[5, 11, 18, 24, 31, 37, 44, 50, 57, 63, 70]
[6, 12, 19, 25, 32, 38, 45, 52, 58, 65, 71]
[7, 14, 20, 27, 33, 40, 46, 53, 60, 66]
[8, 15, 21, 28, 35, 41, 48, 54, 61, 67]
